Korama's Frontier
21
9
Kenji
Gohzu
#Kenji$I guess it's time for me to show what I'm capable of... Korama's best troops are stationed at their frontier
#Himiko$Don't despair Kenji, I can feel that your father is nearby. Do it for him and me!
#Kenji$I won't let you down Himiko and I'll rescue my father or die trying!
#end_file$11
#Kenji$Victory is ours! We can now set camp on solid ground and prepare for our final stand.
#Himiko$Be proud of what you've accomplished today Kenji, your first victory as an Elisian General!
#end_file$12
1020000000
1320000000
1020000000
8120000000
1020000000
8120000000
1020000000
1020000000
1020000000
9020000000
3020000000
3020000000
3020000000
3020000000
3020000000
8320000000
8320000000
8320000000
8320000000
3020000000
3020000000
1020000000
1320000000
1020000000
8120000000
1020000000
8120000000
1020000000
1020000000
1020000000
9020000000
8220000000
8320000000
3020000000
3020000000
3020000000
3020000000
8320000000
8320000000
3020000000
3020000000
3021201220
1020000000
5020100000
1022101228
1023101328
1022101228
1020000000
1020000000
1020000000
8020000000
9020000000
3021201220
8320000000
3020000000
3020000000
3020000000
3020000000
3020000000
8320000000
3023201328
3022201228
3020000000
1020000000
1021101220
1020000000
1020000000
8120000000
1020000000
1020000000
1020000000
8020000000
9020000000
3023201328
8320000000
3020000000
3020000000
3020000000
3020000000
8220000000
8220000000
8320000000
8220000000
3021201220
1020000000
1020000000
1022101228
1020000000
1022101228
8120000000
1020000000
1020000000
1020000000
9020000000
8220000000
8320000000
3020000000
3020000000
3020000000
8320000000
8220000000
8320000000
8320000000
3022201228
3020000000
1020000000
1021101220
1020000000
1020000000
1020000000
1020000000
1020000000
1020000000
8020000000
9020000000
8220000000
3021201220
3020000000
3020000000
3020000000
3020000000
3020000000
3020000000
3020000000
3020000000
3021201220
1020000000
1020000000
1022101228
1023101328
1020000000
1020000000
1020000000
1020000000
8020000000
9020000000
3021201220
8320000000
3020000000
3020000000
8220000000
3020000000
3020000000
3020000000
3023201328
3022201228
3020000000
1020000000
1021101220
1020000000
1020000000
1020000000
8120000000
1020000000
1020000000
8020000000
9020000000
8220000000
3020000000
3020000000
3020000000
8220000000
8220000000
3020000000
3020000000
9120200000
1220000000
1220000000
1020000000
1020000000
1020000000
1020000000
8120000000
8120000000
1020000000
1020000000
1020000000
9020000000
8220000000
3020000000
3020000000
8220000000
3020000000
3020000000
3020000000
8220000000
8220000000
8220000000
8220000000
