Korama's Frontier
21
9
Kenji
Gohzu
#Kenji$Once upon a time, I wrote a very long text for no real purpose other than testing this motherfucka. You know how it goes fella, that's all.
#Gohzu$I never really read that text, but I wanted to make sure it worked, so I rolled with it.
#Kenji$There's no way in hell I'm going to go buy a tuba and run around to fiesta gallore.
#end_file$11
#Kenji$Once upon a time, I wrote a very long text for no real purpose other than testing this motherfucka. You know how it goes fella, that's all.
#Gohzu$I never really read that text, but I wanted to make sure it worked, so I rolled with it.
#Kenji$There's no way in hell I'm going to go buy a tuba and run around to fiesta gallore.
#end_file$10
1020000000
1020000000
1020000000
8120000000
1020000000
8120000000
1020000000
1020000000
1020000000
9020000000
3020000000
3020000000
3020000000
3020000000
3020000000
3020000000
3020000000
3020000000
3020000000
3020000000
3020000000
1020000000
1021101220
1020000000
1021201220
1020000000
8120000000
1020000000
1020000000
1020000000
9020000000
8220000000
8320000000
3020000000
3020000000
3020000000
3020000000
3020000000
3020000000
3020000000
3020000000
3020000000
1020000000
1020000000
1020000000
8120000000
8120000000
1020000000
1020000000
1020000000
8020000000
9020000000
3020000000
8320000000
3020000000
3020000000
3020000000
3020000000
3020000000
3020000000
3020000000
3020000000
3020000000
1020000000
1020000000
1020000000
1020000000
8120000000
1020000000
1020000000
1020000000
8020000000
9020000000
3020000000
8320000000
3020000000
3020000000
3020000000
3020000000
8220000000
8220000000
8320000000
8220000000
8320000000
1020000000
1020000000
1020000000
1020000000
1020000000
8120000000
1020000000
1020000000
1020000000
9020000000
8220000000
8320000000
3020000000
3020000000
3020000000
8320000000
8220000000
8320000000
8320000000
3020000000
3020000000
1020000000
1020000000
1020000000
1020000000
1020000000
1020000000
1020000000
1020000000
8020000000
9020000000
8220000000
3020000000
3020000000
3020000000
3020000000
3020000000
3020000000
3020000000
3020000000
3020000000
3020000000
1020000000
1020000000
1020000000
8120000000
1020000000
1020000000
1020000000
1020000000
8020000000
9020000000
3020000000
8320000000
3020000000
3020000000
3020000000
3020000000
3020000000
3020000000
3020000000
3020000000
3020000000
1020000000
1020000000
1020000000
1020000000
1020000000
8120000000
1020000000
1020000000
8020000000
9020000000
8220000000
3020000000
3020000000
3020000000
3020000000
3020000000
3020000000
3020000000
3020000000
3020000000
3020000000
1020000000
1020000000
1020000000
1020000000
8120000000
8120000000
1020000000
1020000000
1020000000
9020000000
8220000000
3020000000
3020000000
3020000000
3020000000
3020000000
3020000000
3020000000
3020000000
3020000000
3020000000
