Default Map
17
10
Kenji
Masuka
# Row 0
6320000000
6320000000
6320000000
6320000000
6320000000
6320000000
6320000000
6320000000
6320000000
6320000000
6320000000
7720000000
6320000000
6320000000
6320000000
7120000000
6020000000
# Row 1
1020000000
1021101215
1020000000
1020000000
1020000000
1020000000
1020000000
1020000000
1020000000
1021201215
1020000000
7020000000
1020000000
1020000000
1020000000
6120000000
6020000000
# Row 2
1020000000
1020000000
1020000000
1020000000
1020000000
1020000000
1020000000
1020000000
1020000000
1020000000
1020000000
7020000000
1020000000
1020000000
1020000000
6120000000
6020000000
# Row 3
1020000000
1020000000
1020000000
1020000000
1020000000
1020000000
1020000000
1020000000
1020000000
1020000000
1020000000
7520000000
6920000000
6920000000
6920000000
7620000000
7120000000
# Row 4
1020000000
5020100000
1020000000
1020000000
1020000000
1020000000
1020000000
1020000000
1020000000
1020000000
1020000000
1020000000
1020000000
1020000000
1020000000
1020000000
6120000000
# Row 5
1020000000
1020000000
1020000000
1020000000
1020000000
1020000000
1020000000
1020000000
1020000000
1020000000
1020000000
1020000000
1020000000
1020000000
1020000000
1020000000
6120000000
# Row 6
1020000000
1020000000
1020000000
1020000000
1020000000
1020000000
8120000000
1020000000
1020000000
1020000000
1020000000
1020000000
1020000000
1020000000
1020000000
1020000000
6120000000
# Row 7
1020000000
1020000000
1020000000
1020000000
1020000000
8120000000
8020000000
8120000000
1020000000
1020000000
1020000000
1020000000
1020000000
1020000000
1020000000
1020000000
6120000000
# Row 8
8020000000
8020000000
8120000000
1020000000
8020000000
8020000000
8020000000
8020000000
8120000000
1020000000
1020000000
1020000000
1020000000
5020200000
1020000000
1020000000
6120000000
# Row 9
8020000000
8020000000
8020000000
8120000000
1020000000
1020000000
1020000000
1020000000
1020000000
1020000000
1020000000
1020000000
1020000000
1020000000
1020000000
1020000000
6120000000
